000000000000000000
000000000000000000
000000000000000000
001100000000000000
021101000000000000
111111111111111111