000000000000000000
000000000000000000
000000000000000000
000000000000000000
020000000011101000
111111111111111111